+-+-+-+-+
|     | |
+ +-+ +-+
|   | | |
+-+ +-+-+
|     | |
+-+ +-+-+
|       |
+-+-+ +-+
|       |
+-+-+-+-+